######
#@...#
#....#
#....#
######
