###...###
##.....##
#.......#
...@.....
#.......#
##.....##
###...###