############
#@.........#
##########.#
#..........#
#.##########
#..........#
##########.#
#..........#
############
